NO    texture/north_wall.xpm
SO    texture/south_wall.xpm
EA    texture/east_wall.xpm
WE    texture/west_wall.xpm

PN    texture/player_n.xpm
PS    texture/player_s.xpm
PE    texture/player_e.xpm
PW    texture/player_w.xpm
E     texture/empty.xpm

F 41,2,10
C 55,44,28

1111111111111111111111111111111111111111111111111111
1000000000000000000000000000000000000000000000000001
1000000100111000110110001100001111100001100001000101
1000000100100000101010010010001000000010010000101001
1000000100111000101010011110001011100011110000010001
10000S0100001000100010100001001000100100001000010001
1000000100111000100010100001001111100100001000010001
1000000000000000000000000000000000000000000000000001
1111111111111111111111111111111111111111111111111111