NO    texture/north_wall.xpm
SO    texture/south_wall.xpm
EA    texture/east_wall.xpm
WE    texture/west_wall.xpm

F 70,58,38
C 83,69,44

11111111111111111111111111
10000000001000001000000001
10000000001000001000000001
10000000001000001000000001
10000000001000001000000001
10000S0000P000000000000001
11111111111111111111111111