

NO            NORTH             



      SO     SOUTH 

      EA    EAST
WE   WEST 
F 255,255,255
C 1,1,1

         1111111111111111111111111
         1000000000110000000000001
         1011000001110000000000001
         100100N000000000000000001
111111111011000001110000000000001
10000000001100000111111111111111
11110111111111011100000000001
11110111111111011101010010001
11000000110101011100000010001
10000000000000001100000010001
10000000000000001101010010001
1100000111010101111101111000111
11110111 1110101 101111010001
11111111 1111111 111111111111




