

NO            NORTH             



      SO     SOUTH 

      EA    EAST
WE   WEST 
F 255,255,255,123
11111111111111111111111111111
10000000000000000000000000001
10000000000000000000000000001
10000000000000000000000000001
10000000000000000000000000001
10000000000000000000000000001
10000000000000000000000000001
10000000000000000000000000001
10000000000000000000000000001
10000000000000000000000000001
11111111111111111111111111111
C 1,1,1