NO    src/texture/walls/north_wall.xpm
EA    src/texture/walls/east_wall.xpm

F 41,2,10
SO    src/texture/walls/south_wall.xpm

C 55,44,28
WE   src/texture/walls/west_wall.xpm

1111111111111111111111111111111111111111111111111111
1000000000000000000000000000000000000000000000100001
10000001001110001101100011000011111000011000011
10000001001000001010100100100010000000100100001
1000000100111000101010011110001011100011110000010001
1000000100001000100010100001001000100100001000010001
1000000100111000100010100001000000000100001000010001
100000000S000000000000000000000000000000000000001111
1000000000000000000000000000000000000000000000000001
1111111111111111111111111111111111111111111111111111
