NO    texture/NORD.xpm
SO    texture/SOUTH.xpm
EA    texture/EAST.xpm
WE    texture/WEST.xpm

F 34,139,34
C 135,206,235

         1111111111111111111111111
         1000000000110000000000001
         1011000001110000000000001
         100100E000000000000000001
111111111011000001110000000000001
10000000001100000111111111111111
11110111111111011100000000001
11110111111111011101010010001
11000000110101011100000010001
10000000000000001100000010001
10000000000000001101010010001
11000001110101011111011110001
11110111 1110101 101111010001
11111111 1111111 111111111111