NO    texture/NORD.xpm
SO    texture/SOUTH.xpm
EA    texture/EAST.xpm
WE    texture/WEST.xpm

F 34,139,34
C 135,206,200

                111111111
        11111111100000001
        1000E000000010001
        10000001000000001
        11111111111111111