NO    texture/north_wall.xpm
SO    texture/south_wall.xpm
EA    texture/east_wall.xpm
WE    texture/west_wall.xpm

F 70,58,38
C 83,69,44

11111111111111111111111111111111111111111111111111111111111111111111111111111111111111
10000000000000000000000000000000000000000000000000000000000000000000000000000000000001
10111111111111111111111111111111000011111111111111111111111111111111111111111111111001
10100000000000000000000000000111000010000000000000000000000000000000000000000000001001
10101111111111111111111111110111000010111111111111111111111111111111111111111111001001
10101000000000000000000000110111000010100000000000000000000000000000000000000101001001
10101011111111111111111110110111000010101111111111111111111111111111111111110101001001
10101010000000000000000110110111000010101000000000000000000000000000000000110101001001
10101010111111111111110110110111000010101011111111111111111111111111111110110101001001
10101010100000000000110110110111000010101010000000000000000000000000000110110101001001
10101010101111111110110110110111000010101010111111111111111111111111110110110101001001
10101010101000000010110110110111000010101010100000000000000000000000110110110101001001
10101010101011110110110110110111000010101010101111111111111111111110110110110101001001
10101010101010000110110110110111000010101010101000000000000000000110110110110101001001
10101010101010110110110110110111000010101010101011111111111111110110110110110101001001
10101010101010110110110110110111000010101010101010000000000000110110110110110101001001
10101010101010110110110110110111000010101010101010111111111110110110110110110101001001
101010101010101101101101101101110N0010101010101010100000000010110110110110110101001001
10101010101010110110110110110111000010101010101010101111110110110110110110110101001001
10101010101010110110110110110111000010101010101010101000010110110110110110110101001001
10101010101010110110110110110111000010101010101010101011110110110110110110110101001001
10101010101010110110110110110111000010101010101010101010000110110110110110110101001001
10101010101010110110110110110111000010101010101010101010110110110110110110110101001001
10101010101010110110110110110111000010101010101010101010110110110110110110110101001001
10101010101010110110110110110111000010101010101010101010110110110110110110110101001001
10101010101010110110110110110111000010101010101010101010110110110110110110110101001001
10101010101010110110110110110111000010101010101010101010110110110110110110110101001001
10101010101010110110110110110111000010101010101010101010110110110110110110110101001001
10101010101010110110110110110111000010101010101010101010110110110110110110110101001001
10101010101010110110110110110111000010101010101010101010110110110110110110110101001001
10000000000000000000000000000000000000000000000000000000000000000000000000000000000001
11111111111111111111111111111111111111111111111111111111111111111111111111111111111111
