NO    texture/north_wall.xpm
SO    texture/south_wall.xpm
EA    texture/east_wall.xpm
WE    texture/west_wall.xpm

F 41,2,10
C 51,40,24

11111111111111111111111111
10000000001000001000000001
10000000001000001000000001
10000000001000001000000001
10000000001000001000000001
10000S00000000000000000001
11111111111111111111111111